2.000000000000000111e-01,-4.898587196589413075e-17,4.300626381190823522e-01
1.999003178252347634e-01,-6.313709952962049364e-03,4.300516679157738165e-01
1.996013706662986831e-01,-1.262112626253492076e-02,4.300187025363489401e-01
1.991034565202211837e-01,-1.891596155896907785e-02,4.299635770037639193e-01
1.984070717186516009e-01,-2.519194101354331819e-02,4.298860141125558365e-01
1.975129104331047325e-01,-3.144280859345021523e-02,4.297856210093921603e-01
1.964218639829960755e-01,-3.766233329794370366e-02,4.296618842960621687e-01
1.951350199471547364e-01,-4.384431536953829062e-02,4.295141635402439095e-01
1.936536610797014168e-01,-4.998259247406175443e-02,4.293416830393508854e-01
1.919792640313714160e-01,-5.607104584340286829e-02,4.291435216367108230e-01
1.901134978775565754e-01,-6.210360637483382240e-02,4.289186003352816745e-01
1.880582224545351566e-01,-6.807426068082252091e-02,4.286656673895770653e-01
1.858154865055461069e-01,-7.397705708330938601e-02,4.283832804783510029e-01
1.856144681453904266e-01,-7.447999204554098251e-02,4.283567134268537191e-01
1.833875256385577301e-01,-7.980611154646828631e-02,4.280643221585800906e-01
1.807767600977646660e-01,-8.555561354204208047e-02,4.277112303356847556e-01
1.779857923510360374e-01,-9.121983184140325385e-02,4.273223114252652777e-01
1.750174044957186759e-01,-9.679312022856786935e-02,4.268950573159435158e-01
1.727289374681202916e-01,-1.008202071071776368e-01,4.265531062124248707e-01
1.718745554853823854e-01,-1.022699231284653482e-01,4.264239845568149057e-01
1.685603781802700873e-01,-1.076447811448578151e-01,4.259004388874743641e-01
1.650781762243952455e-01,-1.129123365023836228e-01,4.253277025823288260e-01
1.617113352097323264e-01,-1.176836609928735566e-01,4.247494989979960223e-01
1.614314207523972478e-01,-1.180673383873054594e-01,4.247003399112510569e-01
1.576237469294385074e-01,-1.231046481816358007e-01,4.240001984830367721e-01
1.536589503275941349e-01,-1.280192445854214656e-01,4.232342895106442904e-01
1.522344592637150384e-01,-1.297099433840146754e-01,4.229458917835671738e-01
1.495409831423417379e-01,-1.328062286220863253e-01,4.223828003910187756e-01
1.452739502529277471e-01,-1.374608285218369974e-01,4.214420962297947271e-01
1.439796311359325398e-01,-1.388159422327306380e-01,4.211422845691382144e-01
1.408621051305343763e-01,-1.419784044782666510e-01,4.203915232406507108e-01
1.367355128266581621e-01,-1.459568413334256798e-01,4.193386773547094770e-01
1.363098455983266788e-01,-1.463544532734154802e-01,4.192253157377964778e-01
1.316217094476075100e-01,-1.505846127666754519e-01,4.179105534967044178e-01
1.303540492520522676e-01,-1.516832945435769853e-01,4.175350701402806286e-01
1.268023699144476546e-01,-1.546646662430679053e-01,4.164294555487744742e-01
1.246806124163177681e-01,-1.563801294522163821e-01,4.157314629258516692e-01
1.218566310213033410e-01,-1.585905466165557220e-01,4.147507631094874969e-01
1.196103500696296812e-01,-1.602914974545457394e-01,4.139278557114229318e-01
1.167894227882611963e-01,-1.623583404842042222e-01,4.128314071121055862e-01
1.150610879470487513e-01,-1.635877319374576810e-01,4.121242484969939723e-01
1.116057963186880553e-01,-1.659642920271451605e-01,4.106156460335281255e-01
1.109624306988862968e-01,-1.663951290554950835e-01,4.103206412825651239e-01
1.072737467762512331e-01,-1.687967513093327765e-01,4.085170340681362755e-01
1.063109187641802511e-01,-1.694048067544597913e-01,4.080122216449434958e-01
1.039434043335521612e-01,-1.708676935396264140e-01,4.067134268537074271e-01
1.009126447604407062e-01,-1.726749493338657349e-01,4.049098196392785787e-01
1.009100681738355487e-01,-1.726764550862446568e-01,4.049081817148156293e-01
9.819035848650095599e-02,-1.742373481785476352e-01,4.031062124248496192e-01
9.570032690465182790e-02,-1.756173323745204295e-01,4.013026052104208818e-01
9.540862823297775741e-02,-1.757759757722921756e-01,4.010756206033798121e-01
9.345710902312615032e-02,-1.768212904970425658e-01,3.994989979959920334e-01
9.141170783005837797e-02,-1.778873229648252619e-01,3.976953907815630740e-01
8.981208289658396127e-02,-1.787002791429748716e-01,3.961540175189665614e-01
8.954896693324199131e-02,-1.788322748308848742e-01,3.958917835671343366e-01
8.787522581059059590e-02,-1.796606375607570916e-01,3.940881763527053772e-01
8.635538768483329297e-02,-1.803960837097140224e-01,3.922845691382765287e-01
8.498101073699514119e-02,-1.810475843918352978e-01,3.904809619238477914e-01
8.412601092275671932e-02,-1.814464501890963311e-01,3.892386599832974858e-01
8.375022230934439649e-02,-1.816202088511501556e-01,3.886773547094188319e-01
8.266122818948073991e-02,-1.821184267288914471e-01,3.868737474949899835e-01
8.169527491276995512e-02,-1.825537785336883712e-01,3.850701402805611351e-01
8.084637950569797948e-02,-1.829313065629299684e-01,3.832665330661322867e-01
8.010904796673024020e-02,-1.832553967387157701e-01,3.814629258517034383e-01
7.947847602072129203e-02,-1.835297573948803385e-01,3.796593186372745898e-01
7.895071899070112142e-02,-1.837574052136439762e-01,3.778557114228457414e-01
7.852275291753418873e-02,-1.839406895557692545e-01,3.760521042084167820e-01
7.835608031169859211e-02,-1.840117514676349320e-01,3.751438591640247622e-01
7.819458241181935498e-02,-1.840804369873159374e-01,3.742484969939879336e-01
7.796342921162499606e-02,-1.841784561385070018e-01,3.724448897795591962e-01
7.782594091017831783e-02,-1.842365949572598860e-01,3.706412825651302367e-01
7.778116326128475810e-02,-1.842555036945202618e-01,3.688376753507013883e-01
7.782818882913229708e-02,-1.842356453664082128e-01,3.670340681362725399e-01
7.796615667251169390e-02,-1.841773015703003502e-01,3.652304609218436915e-01
7.819436434403873037e-02,-1.840805296190548557e-01,3.634268537074148431e-01
7.835608031169859211e-02,-1.840117514676349320e-01,3.625081904835140700e-01
7.851455707987625710e-02,-1.839441880749453362e-01,3.616232464929861057e-01
7.892814551471326323e-02,-1.837671021853700959e-01,3.598196392785571462e-01
7.943365430463317223e-02,-1.835491611634660625e-01,3.580160320641281868e-01
8.003236866748517087e-02,-1.832888975510293950e-01,3.562124248496994494e-01
8.072601799663831068e-02,-1.829844529417907484e-01,3.544088176352706010e-01
8.151658574491310594e-02,-1.826336394219099934e-01,3.526052104208416416e-01
8.240612132791633182e-02,-1.822340011295607298e-01,3.508016032064129042e-01
8.339661768654031693e-02,-1.817828489116754820e-01,3.489979959919839447e-01
8.412601092275671932e-02,-1.814464501890963311e-01,3.477901212849969226e-01
8.449535890682735584e-02,-1.812747481675438255e-01,3.471943887775550963e-01
8.571117079095032232e-02,-1.807030580860339297e-01,3.453907815631263589e-01
8.703539380132305214e-02,-1.800689874071841057e-01,3.435871743486973995e-01
8.847045023637561956e-02,-1.793682787868941808e-01,3.417835671342685511e-01
8.981208289658396127e-02,-1.787002791429748716e-01,3.402179382806578833e-01
9.002246871794977734e-02,-1.785943871624350865e-01,3.399799599198395916e-01
9.171456139797329321e-02,-1.777313681587394667e-01,3.381763527054108542e-01
9.352860722768567558e-02,-1.767834823450689652e-01,3.363727454909820058e-01
9.540862823297775741e-02,-1.757759757722921756e-01,3.346233363839813957e-01
9.546893624602971473e-02,-1.757432280688263626e-01,3.345691382765530464e-01
9.757205633530863231e-02,-1.745843458689792238e-01,3.327655310621243090e-01
9.980769162897636104e-02,-1.733159677920507180e-01,3.309619238476953496e-01
1.009100681738355487e-01,-1.726764550862446568e-01,3.301140629201274046e-01
1.022009522941552673e-01,-1.719155762290543732e-01,3.291583166332665011e-01
1.047517365383888593e-01,-1.703733362125423034e-01,3.273547094188377637e-01
1.063109187641802511e-01,-1.694048067544597913e-01,3.262993664350548051e-01
1.074619585339236516e-01,-1.686769915194520075e-01,3.255511022044088043e-01
1.103417324871016486e-01,-1.668073801477167883e-01,3.237474949899799559e-01
1.116057963186880553e-01,-1.659642920271451605e-01,3.229823500062089514e-01
1.133955320562630154e-01,-1.647466336823822097e-01,3.219438877755511075e-01
1.166123303089735136e-01,-1.624855821908850473e-01,3.201402805611222591e-01
1.167894227882611963e-01,-1.623583404842042222e-01,3.200429443795374529e-01
1.200327975819750759e-01,-1.599753965603604999e-01,3.183366733466934106e-01
1.218566310213033410e-01,-1.585905466165557220e-01,3.174008810079713139e-01
1.236259274501573940e-01,-1.572152348282074841e-01,3.165330661322645622e-01
1.268023699144475158e-01,-1.546646662430680164e-01,3.150030247498310509e-01
1.273971428225958991e-01,-1.541751212116893588e-01,3.147294589178357138e-01
1.313574236420982089e-01,-1.508152089615312497e-01,3.129258517034067544e-01
1.316217094476075100e-01,-1.505846127666754519e-01,3.128059681848148199e-01
1.355094738723277015e-01,-1.470958275779599977e-01,3.111222444889780170e-01
1.363098455983266788e-01,-1.463544532734154802e-01,3.107755368014162856e-01
1.398341209124407125e-01,-1.429909739411719394e-01,3.093186372745491686e-01
1.408621051305343763e-01,-1.419784044782666510e-01,3.088904908318407805e-01
1.443233389239273745e-01,-1.384585636277120835e-01,3.075150300601202091e-01
1.452739502529277471e-01,-1.374608285218369974e-01,3.071316637461353749e-01
1.489643720397844651e-01,-1.334526727450322803e-01,3.057114228456914717e-01
1.495409831423417379e-01,-1.328062286220863253e-01,3.054845813313346592e-01
1.536589503275940238e-01,-1.280192445854216043e-01,3.039375570090493972e-01
1.537418946329006109e-01,-1.279196225552830801e-01,3.039078156312625123e-01
1.576237469294385074e-01,-1.231046481816358007e-01,3.024709745788693449e-01
1.586622503455082100e-01,-1.217632551934255680e-01,3.021042084168336639e-01
1.614314207523970257e-01,-1.180673383873057508e-01,3.010869488524782756e-01
1.636713737090879084e-01,-1.149420785795180477e-01,3.003006012024048155e-01
1.650781762243952455e-01,-1.129123365023836228e-01,2.997827388208916255e-01
1.685603781802702539e-01,-1.076447811448574959e-01,2.985551467815318882e-01
1.687330684307014883e-01,-1.073738870394483763e-01,2.984969939879759671e-01
1.718745554853823854e-01,-1.022699231284653482e-01,2.973753392696288356e-01
1.738652509035735483e-01,-9.884773405717212080e-02,2.966933867735471186e-01
1.750174044957186759e-01,-9.679312022856786935e-02,2.962708189059754527e-01
1.779857923510358708e-01,-9.121983184140357304e-02,2.952258063957601819e-01
1.789821174035141349e-01,-8.924909887362830752e-02,2.948897795591181592e-01
1.807767600977646660e-01,-8.555561354204208047e-02,2.942329923100020506e-01
1.833875256385577301e-01,-7.980611154646828631e-02,2.933110250375726147e-01
1.840537177110371791e-01,-7.825745329836547581e-02,2.930861723446895328e-01
1.858154865055461069e-01,-7.397705708330938601e-02,2.924308867402778955e-01
1.880582224545351566e-01,-6.807426068082252091e-02,2.916228012878903653e-01
1.890422440205575816e-01,-6.529188292331572496e-02,2.912825651302605734e-01
1.901134978775565754e-01,-6.210360637483382240e-02,2.908666926829103772e-01
1.919792640313714160e-01,-5.607104584340286829e-02,2.901688353397307574e-01
1.936536610797014168e-01,-4.998259247406175443e-02,2.895540052232043471e-01
1.938716525997139228e-01,-4.913025868297300064e-02,2.894789579158316140e-01
1.951350199471547364e-01,-4.384431536953829062e-02,2.889756120399624151e-01
1.964218639829960755e-01,-3.766233329794370366e-02,2.884742069968354028e-01
1.975129104331047325e-01,-3.144280859345021523e-02,2.880542104178852036e-01
1.984070717186515731e-01,-2.519194101354367554e-02,2.877134484989353758e-01
1.985197713396927299e-01,-2.428786502013122531e-02,2.876753507014028766e-01
1.991034565202211837e-01,-1.891596155896907785e-02,2.874265569936404474e-01
1.996013706662986831e-01,-1.262112626253492076e-02,2.872198168402358420e-01
1.999003178252347634e-01,-6.313709952962049364e-03,2.870961850623699463e-01
2.000000000000000111e-01,-4.898587196589413075e-17,2.870550429380485657e-01
