2.000000000000000111e-01,0.000000000000000000e+00,1.692478134316370286e-01
1.999003178252347634e-01,6.313709952962105743e-03,1.692911214928975450e-01
1.996013706662986831e-01,1.262112626253472994e-02,1.694212618951709826e-01
1.991034565202212114e-01,1.891596155896899112e-02,1.696388859332181309e-01
1.984070717186515731e-01,2.519194101354351248e-02,1.699450879560525096e-01
1.975129104331047603e-01,3.144280859345015972e-02,1.703414188662138451e-01
1.973057588551242469e-01,3.271754151221578644e-02,1.704408817635270634e-01
1.964218639829961033e-01,3.766233329794357876e-02,1.708250348439271371e-01
1.951350199471547364e-01,4.384431536953826980e-02,1.714009040553136631e-01
1.936536610797014446e-01,4.998259247406167116e-02,1.720732957546285413e-01
1.932967611302636168e-01,5.134551720013946774e-02,1.722444889779559118e-01
1.919792640313714160e-01,5.607104584340288217e-02,1.728405254063767882e-01
1.901134978775566031e-01,6.210360637483376689e-02,1.737096576915088675e-01
1.894181652924324666e-01,6.419313559290228122e-02,1.740480961923848713e-01
1.880582224545351289e-01,6.807426068082256254e-02,1.746837028190244001e-01
1.858154865055461347e-01,7.397705708330935825e-02,1.757692067141716774e-01
1.856531735965369079e-01,7.438346008041125945e-02,1.758517034068136087e-01
1.833875256385577579e-01,7.980611154646820304e-02,1.769722191421748136e-01
1.820594148407252699e-01,8.279111949872830500e-02,1.776553106212424571e-01
1.807767600977647215e-01,8.555561354204192781e-02,1.783025962775191542e-01
1.785835260960619009e-01,9.004401261104029441e-02,1.794589178356714165e-01
1.779857923510360651e-01,9.121983184140319834e-02,1.797704539389421430e-01
1.752518626389865108e-01,9.636796480971160372e-02,1.812625250501001539e-01
1.750174044957187591e-01,9.679312022856775832e-02,1.813899319895985740e-01
1.720742066269332349e-01,1.019336422076219800e-01,1.830661322645291134e-01
1.718745554853824131e-01,1.022699231284653482e-01,1.831801590621696119e-01
1.690517305316135976e-01,1.068714761022168669e-01,1.848697394789579618e-01
1.685603781802701429e-01,1.076447811448577041e-01,1.851668238598425664e-01
1.661812956812529496e-01,1.112824198411410254e-01,1.866733466933866992e-01
1.650781762243952455e-01,1.129123365023836228e-01,1.873842777204752230e-01
1.634576191437525639e-01,1.152458534779275401e-01,1.884769539078156586e-01
1.614314207523970812e-01,1.180673383873056814e-01,1.898780349222976560e-01
1.608742738415246398e-01,1.188253677291265520e-01,1.902805611222445070e-01
1.584570399961794385e-01,1.220301867393851075e-01,1.920841683366733554e-01
1.576237469294384796e-01,1.231046481816358562e-01,1.927299852450533035e-01
1.561929504057949780e-01,1.249150200877895689e-01,1.938877755511022039e-01
1.540632033667215517e-01,1.275324639783306235e-01,1.956913827655310523e-01
1.536589503275941626e-01,1.280192445854214378e-01,1.960511790458022152e-01
1.521029781353817056e-01,1.298640983580435226e-01,1.974949899799599007e-01
1.502699417553635675e-01,1.319808493867183907e-01,1.992985971943887491e-01
1.495409831423418212e-01,1.328062286220862420e-01,2.000631628607105195e-01
1.485888996144733021e-01,1.338706051056764990e-01,2.011022044088177085e-01
1.470520739222114792e-01,1.355569531790105364e-01,2.029058116232465570e-01
1.456385907709521477e-01,1.370744355386924185e-01,2.047094188376752943e-01
1.452739502529278859e-01,1.374608285218368586e-01,2.052195069573933828e-01
1.443830948399816294e-01,1.383962496761703131e-01,2.065130260521042538e-01
1.432670091697207659e-01,1.395512955280715228e-01,2.083166332665331022e-01
1.422811436804312657e-01,1.405563095452796729e-01,2.101202404809619506e-01
1.414273005999334698e-01,1.414154116248156901e-01,2.119238476953907990e-01
1.408621051305344318e-01,1.419784044782665677e-01,2.133370087182142050e-01
1.407111444106468323e-01,1.421280191892017319e-01,2.137274549098196474e-01
1.401413830654741344e-01,1.426898481059393486e-01,2.155310621242484959e-01
1.397003261971246912e-01,1.431216924872570073e-01,2.173346693386773443e-01
1.393876535208182499e-01,1.434262250983422138e-01,2.191382765531063037e-01
1.392032032658093721e-01,1.436052512986128737e-01,2.209418837675350411e-01
1.391469400513190569e-01,1.436597684613010462e-01,2.227454909819638895e-01
1.392186971496442716e-01,1.435902307399623823e-01,2.245490981963928490e-01
1.394177683773661913e-01,1.433969520620123894e-01,2.263527054108215864e-01
1.397424776652448630e-01,1.430805365379181904e-01,2.281563126252505458e-01
1.401898596745304315e-01,1.426422211143512364e-01,2.299599198396793942e-01
1.407555402651107512e-01,1.420840521827723968e-01,2.317635270541081316e-01
1.408621051305344318e-01,1.419784044782665677e-01,2.320474899781928557e-01
1.414519855024934103e-01,1.413907203369527965e-01,2.335671342685370910e-01
1.422608758574384902e-01,1.405768231262695400e-01,2.353707414829658284e-01
1.431708802869627872e-01,1.396499159965954584e-01,2.371743486973948989e-01
1.441732863632640693e-01,1.386148025977610165e-01,2.389779559118236363e-01
1.452584945351832191e-01,1.374771608863528394e-01,2.407815631262524847e-01
1.452739502529278859e-01,1.374608285218368586e-01,2.408057387059586163e-01
1.464542453566420599e-01,1.362026211826207478e-01,2.425851703406814441e-01
1.477115604359645340e-01,1.348380321481012778e-01,2.443887775551101815e-01
1.490146528268939397e-01,1.333965263523764766e-01,2.461923847695391410e-01
1.495409831423418212e-01,1.328062286220862420e-01,2.469070075642406104e-01
1.503747991971225162e-01,1.318613657081750545e-01,2.479959919839679894e-01
1.517615779326115799e-01,1.302629013318982731e-01,2.497995991983967268e-01
1.531328390101336367e-01,1.286480999342644593e-01,2.516032064128256862e-01
1.536589503275941626e-01,1.280192445854214378e-01,2.523170996094138974e-01
1.544950772888077362e-01,1.270089409983617412e-01,2.534068136272545346e-01
1.558093223449238673e-01,1.253932018508802926e-01,2.552104208416833830e-01
1.570289516654513051e-01,1.238624573422042047e-01,2.570140280561122315e-01
1.576237469294384796e-01,1.231046481816358562e-01,2.579908175768121370e-01
1.581486732072220069e-01,1.224295600040909565e-01,2.588176352705410799e-01
1.591400520464825996e-01,1.211381188340103360e-01,2.606212424849699283e-01
1.599518480609710136e-01,1.200641757639640539e-01,2.624248496993987767e-01
1.605573627558264382e-01,1.192532316748437515e-01,2.642284569138277361e-01
1.609298484109795702e-01,1.187500900648885693e-01,2.660320641282564735e-01
1.610428704558377888e-01,1.185967700881615516e-01,2.678356713426853219e-01
1.608709989298883203e-01,1.188298014106725642e-01,2.696392785571142814e-01
1.603907103807301615e-01,1.194772782731710337e-01,2.714428857715431298e-01
1.595813166316805143e-01,1.205562249827827337e-01,2.732464929859719782e-01
1.584257462763485336e-01,1.220708110761210829e-01,2.750501002004008266e-01
1.576237469294384796e-01,1.231046481816358562e-01,2.760044035826059727e-01
1.569394234981353886e-01,1.239758740726312064e-01,2.768537074148296750e-01
1.551329822514646017e-01,1.262289896092287367e-01,2.786573146292585235e-01
1.536589503275941626e-01,1.280192445854214378e-01,2.798860372221288473e-01
1.529974136870483337e-01,1.288091278018533847e-01,2.804609218436873719e-01
1.505782470505565573e-01,1.316289919249614415e-01,2.822645290581163313e-01
1.495409831423418212e-01,1.328062286220862420e-01,2.829420666333562484e-01
1.478883894374360963e-01,1.346440651109481468e-01,2.840681362725450687e-01
1.452739502529278859e-01,1.374608285218368586e-01,2.856602474873227160e-01
1.449408921985155807e-01,1.378119652595458933e-01,2.858717434869739171e-01
1.418029229958079618e-01,1.410387571905147019e-01,2.876753507014028766e-01
1.408621051305344318e-01,1.419784044782665677e-01,2.881715215959601006e-01
1.384886824989470522e-01,1.442944379375235842e-01,2.894789579158316140e-01
1.363098455983267621e-01,1.463544532734153414e-01,2.905956651244949174e-01
1.350268113198559439e-01,1.475390125519078777e-01,2.912825651302605734e-01
1.316217094476075378e-01,1.505846127666754242e-01,2.929990466834459517e-01
1.314562656326051793e-01,1.507290623135762453e-01,2.930861723446894218e-01
1.278406219095188090e-01,1.538075921071110908e-01,2.948897795591181592e-01
1.268023699144477379e-01,1.546646662430678221e-01,2.953863209586281013e-01
1.241904373594976685e-01,1.567696886150402868e-01,2.966933867735471186e-01
1.218566310213033549e-01,1.585905466165557220e-01,2.978250930763239324e-01
1.205322885924984960e-01,1.595993966362487804e-01,2.984969939879759671e-01
1.168954668182710099e-01,1.622820071275263010e-01,3.003006012024048155e-01
1.167894227882612795e-01,1.623583404842041666e-01,3.003519219442757904e-01
1.133316032567315279e-01,1.647906177646616122e-01,3.021042084168336639e-01
1.116057963186880553e-01,1.659642920271451605e-01,3.029717826091046784e-01
1.098267199562404928e-01,1.671469161655503854e-01,3.039078156312625123e-01
1.063977495193962758e-01,1.693502846091727576e-01,3.057114228456914717e-01
1.063109187641803066e-01,1.694048067544597913e-01,3.057567408799029551e-01
1.030917747310007848e-01,1.713828637373427388e-01,3.075150300601202091e-01
1.009100681738355210e-01,1.726764550862446568e-01,3.087226585727257944e-01
9.988031989567704161e-02,1.732741229887983792e-01,3.093186372745491686e-01
9.679477728577891293e-02,1.750164880524016919e-01,3.111222444889781280e-01
9.540862823297791007e-02,1.757759757722920924e-01,3.119469887944102404e-01
9.383371472216794906e-02,1.766217256778984390e-01,3.129258517034067544e-01
9.100069591088034981e-02,1.780979318906749376e-01,3.147294589178357138e-01
8.981208289658404453e-02,1.787002791429748161e-01,3.155053232148806175e-01
8.830264534588436187e-02,1.794509482419053004e-01,3.165330661322645622e-01
8.573660419132178578e-02,1.806909923093584502e-01,3.183366733466934106e-01
8.412601092275688586e-02,1.814464501890962755e-01,3.195115646884533755e-01
8.329820046594882399e-02,1.818279675933672512e-01,3.201402805611222591e-01
8.099770578282694533e-02,1.828643531635365249e-01,3.219438877755511075e-01
7.881130115283302429e-02,1.838172429632145832e-01,3.237474949899799559e-01
7.835608031169863374e-02,1.840117514676349320e-01,3.241360944892999751e-01
7.675953824807089931e-02,1.846834407518523069e-01,3.255511022044088043e-01
7.482399235005653126e-02,1.854760636006670405e-01,3.273547094188377637e-01
7.299686800194697678e-02,1.862027316177352343e-01,3.291583166332665011e-01
7.250804265572489971e-02,1.863936258304869920e-01,3.296627151497769082e-01
7.129127463224516070e-02,1.868623936518790385e-01,3.309619238476953496e-01
6.969467345758031951e-02,1.874637364709272336e-01,3.327655310621243090e-01
6.819852876425401556e-02,1.880131928200551306e-01,3.345691382765530464e-01
6.679992369303859590e-02,1.885146418573481197e-01,3.363727454909820058e-01
6.658772740595225725e-02,1.885896989734874296e-01,3.366616992019549337e-01
6.550779559207091374e-02,1.889675334989253108e-01,3.381763527054108542e-01
6.430810240046076764e-02,1.893791645499891263e-01,3.399799599198395916e-01
6.319530381681810749e-02,1.897534020129811871e-01,3.417835671342685511e-01
6.216645859038304883e-02,1.900929546993528063e-01,3.435871743486973995e-01
6.121897543344300557e-02,1.904002023288828005e-01,3.453907815631263589e-01
6.060103606137454829e-02,1.905977818031678594e-01,3.466692675369792975e-01
6.035312861784818822e-02,1.906764271378018905e-01,3.471943887775550963e-01
5.956989224434028340e-02,1.909225705305627185e-01,3.489979959919839447e-01
5.886135409676952757e-02,1.911422009758564911e-01,3.508016032064129042e-01
5.822583225981619454e-02,1.913367514557821336e-01,3.526052104208416416e-01
5.766163802857676712e-02,1.915075337940035094e-01,3.544088176352706010e-01
5.716708408150505960e-02,1.916557447550637228e-01,3.562124248496994494e-01
5.674056754392343971e-02,1.917824496527079647e-01,3.580160320641281868e-01
5.638069989695371209e-02,1.918885527568792992e-01,3.598196392785571462e-01
5.608643845468291866e-02,1.919747676687461602e-01,3.616232464929859947e-01
5.585717323274968366e-02,1.920416001767497327e-01,3.634268537074148431e-01
5.569273889567034896e-02,1.920893511736105896e-01,3.652304609218436915e-01
5.559334864189566933e-02,1.921181396609404901e-01,3.670340681362724289e-01
5.555947581677037755e-02,1.921279382259792889e-01,3.688376753507013883e-01
5.559172940734339458e-02,1.921186082124808348e-01,3.706412825651302367e-01
5.569077390728221361e-02,1.920899208745945053e-01,3.724448897795591962e-01
5.585733038261467276e-02,1.920415544681083608e-01,3.742484969939879336e-01
5.609226819287391197e-02,1.919730643839877571e-01,3.760521042084167820e-01
5.639676491714595841e-02,1.918838318016402866e-01,3.778557114228457414e-01
5.677248678943536131e-02,1.917730031671387170e-01,3.796593186372745898e-01
5.722173285848718843e-02,1.916394356302270341e-01,3.814629258517034383e-01
5.774749754601773977e-02,1.914816610727321788e-01,3.832665330661322867e-01
5.835343561377313165e-02,1.912978738827727787e-01,3.850701402805611351e-01
5.904375144055145491e-02,1.910859372529186972e-01,3.868737474949899835e-01
5.982306788028895345e-02,1.908433927318164969e-01,3.886773547094188319e-01
6.060103606137454829e-02,1.905977818031678594e-01,3.902865267664790694e-01
6.069730809867530941e-02,1.905671450947788448e-01,3.904809619238477914e-01
6.167968855165500974e-02,1.902514547123643762e-01,3.922845691382765287e-01
6.276830151582576955e-02,1.898950771474036681e-01,3.940881763527053772e-01
6.396997886847943793e-02,1.894936458131678270e-01,3.958917835671343366e-01
6.529283649223351083e-02,1.890419146718485266e-01,3.976953907815630740e-01
6.658772740595225725e-02,1.885896989734874296e-01,3.993054399581119074e-01
6.674844585998578050e-02,1.885328750517440977e-01,3.994989979959920334e-01
6.836286966205655513e-02,1.879534997055619383e-01,4.013026052104208818e-01
7.013559080231031306e-02,1.872992229103230821e-01,4.031062124248496192e-01
7.208279463246342056e-02,1.865584914121415916e-01,4.049098196392785787e-01
7.250804265572489971e-02,1.863936258304869920e-01,4.052760982933846789e-01
7.424397279253751314e-02,1.857089995233967006e-01,4.067134268537074271e-01
7.662629431070316910e-02,1.847387642597229929e-01,4.085170340681362755e-01
7.835608031169863374e-02,1.840117514676349320e-01,4.097194994570288462e-01
7.925996121833336905e-02,1.836242319185251159e-01,4.103206412825651239e-01
8.218649145125042632e-02,1.823331583199653272e-01,4.121242484969939723e-01
8.412601092275688586e-02,1.814464501890962755e-01,4.132230027254746862e-01
8.543305568287140606e-02,1.808347118135437137e-01,4.139278557114229318e-01
8.905179745178393169e-02,1.790803656758787610e-01,4.157314629258516692e-01
8.981208289658404453e-02,1.787002791429748161e-01,4.160844166044243564e-01
9.311224012154428742e-02,1.770031376545282698e-01,4.175350701402806286e-01
9.540862823297791007e-02,1.757759757722920924e-01,4.184687351675569489e-01
9.767592674172966005e-02,1.745262539996325912e-01,4.193386773547094770e-01
1.009100681738355210e-01,1.726764550862446568e-01,4.204931142056546611e-01
1.028437497529963718e-01,1.715318137744222260e-01,4.211422845691382144e-01
1.063109187641803066e-01,1.694048067544597913e-01,4.222309460867675335e-01
1.087400659587651197e-01,1.678558847800201981e-01,4.229458917835671738e-01
1.116057963186880553e-01,1.659642920271451605e-01,4.237388610525497090e-01
1.155147224828370761e-01,1.632677215181039532e-01,4.247494989979960223e-01
1.167894227882612795e-01,1.623583404842041666e-01,4.250609865626835959e-01
1.218566310213033549e-01,1.585905466165557220e-01,4.262249355705345910e-01
1.233788647651369169e-01,1.574091983629484770e-01,4.265531062124248707e-01
1.268023699144477379e-01,1.546646662430678221e-01,4.272566849318781279e-01
1.316217094476075378e-01,1.505846127666754242e-01,4.281814613973616290e-01
1.325873937025289773e-01,1.497350427627767433e-01,4.283567134268538301e-01
1.363098455983267621e-01,1.463544532734153414e-01,4.290059532473887161e-01
1.408621051305344318e-01,1.419784044782665677e-01,4.297510595383246534e-01
1.435114728574424514e-01,1.392998821187138303e-01,4.301603206412825675e-01
1.452739502529278859e-01,1.374608285218368586e-01,4.304240019914248871e-01
1.495409831423418212e-01,1.328062286220862420e-01,4.310306588158004382e-01
1.536589503275941626e-01,1.280192445854214378e-01,4.315841744121119983e-01
1.566326091199562454e-01,1.243632813987914920e-01,4.319639278557114159e-01
1.576237469294384796e-01,1.231046481816358562e-01,4.320877308731289612e-01
1.614314207523970812e-01,1.180673383873056814e-01,4.325424124425648054e-01
1.650781762243952455e-01,1.129123365023836228e-01,4.329582141230914893e-01
1.685603781802701429e-01,1.076447811448577041e-01,4.333384614100800891e-01
1.718745554853824131e-01,1.022699231284653482e-01,4.336860503765782027e-01
1.726867631899719202e-01,1.008924269654098566e-01,4.337675350701402643e-01
1.750174044957187591e-01,9.679312022856775832e-02,4.339997627324382878e-01
1.779857923510360651e-01,9.121983184140319834e-02,4.342847071332445741e-01
1.807767600977647215e-01,8.555561354204192781e-02,4.345440850151041645e-01
1.833875256385577579e-01,7.980611154646820304e-02,4.347795690881872122e-01
1.858154865055461347e-01,7.397705708330935825e-02,4.349926262030701651e-01
1.880582224545351289e-01,6.807426068082257642e-02,4.351845416658237098e-01
1.901134978775566031e-01,6.210360637483376689e-02,4.353564396589341690e-01
1.919792640313714160e-01,5.607104584340290299e-02,4.355093004110827670e-01
1.927683805842664577e-01,5.329494766785507903e-02,4.355711422845692238e-01
1.936536610797014446e-01,4.998259247406167116e-02,4.356427984454341318e-01
1.951350199471547364e-01,4.384431536953826980e-02,4.357581264126474951e-01
1.964218639829961033e-01,3.766233329794357876e-02,4.358568989370517621e-01
1.975129104331047603e-01,3.144280859345015972e-02,4.359396346871460826e-01
1.984070717186515731e-01,2.519194101354351248e-02,4.360067618838444070e-01
1.991034565202212114e-01,1.891596155896899112e-02,4.360586238075281895e-01
1.996013706662986831e-01,1.262112626253472994e-02,4.360954831370271179e-01
1.999003178252347634e-01,6.313709952962105743e-03,4.361175252239747890e-01
2.000000000000000111e-01,0.000000000000000000e+00,4.361248603792008960e-01
