2.000000000000000111e-01,-4.898587196589413075e-17,4.361248603792007850e-01
1.999003178252347634e-01,-6.313709952962049364e-03,4.361175252239747890e-01
1.996013706662986831e-01,-1.262112626253492076e-02,4.360954831370271179e-01
1.991034565202211837e-01,-1.891596155896907785e-02,4.360586238075281895e-01
1.984070717186515731e-01,-2.519194101354367554e-02,4.360067618838445180e-01
1.975129104331047325e-01,-3.144280859345021523e-02,4.359396346871460826e-01
1.964218639829960755e-01,-3.766233329794370366e-02,4.358568989370517621e-01
1.951350199471547364e-01,-4.384431536953829062e-02,4.357581264126474951e-01
1.936536610797014168e-01,-4.998259247406175443e-02,4.356427984454342428e-01
1.927683805842664855e-01,-5.329494766785496801e-02,4.355711422845692238e-01
1.919792640313714160e-01,-5.607104584340286829e-02,4.355093004110827670e-01
1.901134978775565754e-01,-6.210360637483382240e-02,4.353564396589342800e-01
1.880582224545351566e-01,-6.807426068082252091e-02,4.351845416658237098e-01
1.858154865055461069e-01,-7.397705708330938601e-02,4.349926262030701651e-01
1.833875256385577301e-01,-7.980611154646828631e-02,4.347795690881872122e-01
1.807767600977646660e-01,-8.555561354204208047e-02,4.345440850151041645e-01
1.779857923510360374e-01,-9.121983184140325385e-02,4.342847071332445741e-01
1.750174044957186759e-01,-9.679312022856786935e-02,4.339997627324382878e-01
1.726867631899718925e-01,-1.008924269654098843e-01,4.337675350701402643e-01
1.718745554853823021e-01,-1.022699231284655008e-01,4.336860503765782027e-01
1.685603781802700873e-01,-1.076447811448578151e-01,4.333384614100800891e-01
1.650781762243952455e-01,-1.129123365023836228e-01,4.329582141230914893e-01
1.614314207523970257e-01,-1.180673383873057508e-01,4.325424124425648054e-01
1.576237469294385074e-01,-1.231046481816358007e-01,4.320877308731289612e-01
1.566326091199563564e-01,-1.243632813987914087e-01,4.319639278557114159e-01
1.536589503275941349e-01,-1.280192445854214656e-01,4.315841744121122203e-01
1.495409831423417379e-01,-1.328062286220863253e-01,4.310306588158004382e-01
1.452739502529277471e-01,-1.374608285218369974e-01,4.304240019914248871e-01
1.435114728574423404e-01,-1.392998821187138858e-01,4.301603206412825675e-01
1.408621051305343763e-01,-1.419784044782666510e-01,4.297510595383246534e-01
1.363098455983266788e-01,-1.463544532734154802e-01,4.290059532473887161e-01
1.325873937025288940e-01,-1.497350427627767988e-01,4.283567134268538301e-01
1.316217094476075100e-01,-1.505846127666754519e-01,4.281814613973617401e-01
1.268023699144476546e-01,-1.546646662430679053e-01,4.272566849318781279e-01
1.233788647651367643e-01,-1.574091983629485880e-01,4.265531062124248707e-01
1.218566310213033410e-01,-1.585905466165557220e-01,4.262249355705345910e-01
1.167894227882611963e-01,-1.623583404842042222e-01,4.250609865626835959e-01
1.155147224828369928e-01,-1.632677215181039809e-01,4.247494989979960223e-01
1.116057963186880553e-01,-1.659642920271451605e-01,4.237388610525495980e-01
1.087400659587650087e-01,-1.678558847800202813e-01,4.229458917835670628e-01
1.063109187641802511e-01,-1.694048067544597913e-01,4.222309460867673114e-01
1.028437497529962885e-01,-1.715318137744222815e-01,4.211422845691382144e-01
1.009100681738355487e-01,-1.726764550862446568e-01,4.204931142056546611e-01
9.767592674172967393e-02,-1.745262539996325635e-01,4.193386773547094770e-01
9.540862823297775741e-02,-1.757759757722921756e-01,4.184687351675569489e-01
9.311224012154441232e-02,-1.770031376545282142e-01,4.175350701402806286e-01
8.981208289658396127e-02,-1.787002791429748716e-01,4.160844166044244674e-01
8.905179745178395945e-02,-1.790803656758787332e-01,4.157314629258516692e-01
8.543305568287115626e-02,-1.808347118135438247e-01,4.139278557114229318e-01
8.412601092275671932e-02,-1.814464501890963311e-01,4.132230027254745752e-01
8.218649145125039857e-02,-1.823331583199653549e-01,4.121242484969939723e-01
7.925996121833328578e-02,-1.836242319185251437e-01,4.103206412825651239e-01
7.835608031169859211e-02,-1.840117514676349320e-01,4.097194994570286242e-01
7.662629431070304420e-02,-1.847387642597230484e-01,4.085170340681362755e-01
7.424397279253747151e-02,-1.857089995233967006e-01,4.067134268537075381e-01
7.250804265572478868e-02,-1.863936258304870197e-01,4.052760982933847900e-01
7.208279463246329566e-02,-1.865584914121416471e-01,4.049098196392785787e-01
7.013559080231022980e-02,-1.872992229103230821e-01,4.031062124248496192e-01
6.836286966205659676e-02,-1.879534997055619383e-01,4.013026052104208818e-01
6.674844585998558621e-02,-1.885328750517441809e-01,3.994989979959920334e-01
6.658772740595221562e-02,-1.885896989734874296e-01,3.993054399581120184e-01
6.529283649223334429e-02,-1.890419146718486099e-01,3.976953907815630740e-01
6.396997886847935466e-02,-1.894936458131678547e-01,3.958917835671343366e-01
6.276830151582581119e-02,-1.898950771474036403e-01,3.940881763527053772e-01
6.167968855165496811e-02,-1.902514547123644040e-01,3.922845691382765287e-01
6.069730809867523308e-02,-1.905671450947788725e-01,3.904809619238477914e-01
6.060103606137447196e-02,-1.905977818031678872e-01,3.902865267664790694e-01
5.982306788028886324e-02,-1.908433927318164969e-01,3.886773547094188319e-01
5.904375144055128838e-02,-1.910859372529187528e-01,3.868737474949899835e-01
5.835343561377309002e-02,-1.912978738827727787e-01,3.850701402805611351e-01
5.774749754601764956e-02,-1.914816610727322066e-01,3.832665330661322867e-01
5.722173285848718843e-02,-1.916394356302270341e-01,3.814629258517034383e-01
5.677248678943540988e-02,-1.917730031671386892e-01,3.796593186372747009e-01
5.639676491714591677e-02,-1.918838318016402866e-01,3.778557114228457414e-01
5.609226819287378707e-02,-1.919730643839877848e-01,3.760521042084167820e-01
5.585733038261454786e-02,-1.920415544681084163e-01,3.742484969939879336e-01
5.569077390728221361e-02,-1.920899208745945053e-01,3.724448897795591962e-01
5.559172940734339458e-02,-1.921186082124808348e-01,3.706412825651302367e-01
5.555947581677024572e-02,-1.921279382259793167e-01,3.688376753507013883e-01
5.559334864189550279e-02,-1.921181396609405456e-01,3.670340681362725399e-01
5.569273889567025876e-02,-1.920893511736106174e-01,3.652304609218436915e-01
5.585717323274968366e-02,-1.920416001767497327e-01,3.634268537074148431e-01
5.608643845468296724e-02,-1.919747676687461602e-01,3.616232464929859947e-01
5.638069989695379536e-02,-1.918885527568792715e-01,3.598196392785571462e-01
5.674056754392325930e-02,-1.917824496527080202e-01,3.580160320641281868e-01
5.716708408150485143e-02,-1.916557447550637783e-01,3.562124248496994494e-01
5.766163802857685733e-02,-1.915075337940034816e-01,3.544088176352706010e-01
5.822583225981645128e-02,-1.913367514557820781e-01,3.526052104208416416e-01
5.886135409676948593e-02,-1.911422009758565188e-01,3.508016032064129042e-01
5.956989224434028340e-02,-1.909225705305627185e-01,3.489979959919839447e-01
6.035312861784822985e-02,-1.906764271378018905e-01,3.471943887775550963e-01
6.060103606137447196e-02,-1.905977818031678872e-01,3.466692675369794086e-01
6.121897543344304027e-02,-1.904002023288827727e-01,3.453907815631263589e-01
6.216645859038304883e-02,-1.900929546993528063e-01,3.435871743486973995e-01
6.319530381681823239e-02,-1.897534020129811594e-01,3.417835671342685511e-01
6.430810240046072601e-02,-1.893791645499891541e-01,3.399799599198395916e-01
6.550779559207085823e-02,-1.889675334989253386e-01,3.381763527054108542e-01
6.658772740595221562e-02,-1.885896989734874296e-01,3.366616992019549337e-01
6.679992369303826283e-02,-1.885146418573482308e-01,3.363727454909820058e-01
6.819852876425396004e-02,-1.880131928200551306e-01,3.345691382765530464e-01
6.969467345758015298e-02,-1.874637364709272891e-01,3.327655310621243090e-01
7.129127463224503580e-02,-1.868623936518790662e-01,3.309619238476953496e-01
7.250804265572478868e-02,-1.863936258304870197e-01,3.296627151497769082e-01
7.299686800194692127e-02,-1.862027316177352620e-01,3.291583166332665011e-01
7.482399235005653126e-02,-1.854760636006670405e-01,3.273547094188377637e-01
7.675953824807069115e-02,-1.846834407518523902e-01,3.255511022044088043e-01
7.835608031169859211e-02,-1.840117514676349320e-01,3.241360944893000862e-01
7.881130115283302429e-02,-1.838172429632145832e-01,3.237474949899800669e-01
8.099770578282691758e-02,-1.828643531635365249e-01,3.219438877755511075e-01
8.329820046594875460e-02,-1.818279675933672790e-01,3.201402805611222591e-01
8.412601092275671932e-02,-1.814464501890963311e-01,3.195115646884533755e-01
8.573660419132189681e-02,-1.806909923093583670e-01,3.183366733466934106e-01
8.830264534588427860e-02,-1.794509482419053281e-01,3.165330661322645622e-01
8.981208289658396127e-02,-1.787002791429748716e-01,3.155053232148807285e-01
9.100069591088028043e-02,-1.780979318906749931e-01,3.147294589178357138e-01
9.383371472216806009e-02,-1.766217256778983558e-01,3.129258517034067544e-01
9.540862823297775741e-02,-1.757759757722921756e-01,3.119469887944102404e-01
9.679477728577889906e-02,-1.750164880524016919e-01,3.111222444889780170e-01
9.988031989567702773e-02,-1.732741229887984069e-01,3.093186372745491686e-01
1.009100681738355487e-01,-1.726764550862446568e-01,3.087226585727257944e-01
1.030917747310007848e-01,-1.713828637373427666e-01,3.075150300601202091e-01
1.063109187641802511e-01,-1.694048067544597913e-01,3.057567408799030662e-01
1.063977495193961370e-01,-1.693502846091728409e-01,3.057114228456914717e-01
1.098267199562406315e-01,-1.671469161655503022e-01,3.039078156312625123e-01
1.116057963186880553e-01,-1.659642920271451605e-01,3.029717826091045674e-01
1.133316032567318193e-01,-1.647906177646614179e-01,3.021042084168336639e-01
1.167894227882611963e-01,-1.623583404842042222e-01,3.003519219442759014e-01
1.168954668182711210e-01,-1.622820071275262732e-01,3.003006012024048155e-01
1.205322885924987181e-01,-1.595993966362486138e-01,2.984969939879759671e-01
1.218566310213033410e-01,-1.585905466165557220e-01,2.978250930763239324e-01
1.241904373594974742e-01,-1.567696886150404534e-01,2.966933867735471186e-01
1.268023699144476546e-01,-1.546646662430679053e-01,2.953863209586281013e-01
1.278406219095188645e-01,-1.538075921071110630e-01,2.948897795591181592e-01
1.314562656326051238e-01,-1.507290623135763008e-01,2.930861723446894218e-01
1.316217094476075100e-01,-1.505846127666754519e-01,2.929990466834459517e-01
1.350268113198558051e-01,-1.475390125519080164e-01,2.912825651302605734e-01
1.363098455983266788e-01,-1.463544532734154802e-01,2.905956651244949174e-01
1.384886824989470799e-01,-1.442944379375235564e-01,2.894789579158316140e-01
1.408621051305343763e-01,-1.419784044782666510e-01,2.881715215959601006e-01
1.418029229958081561e-01,-1.410387571905145077e-01,2.876753507014028766e-01
1.449408921985156640e-01,-1.378119652595458100e-01,2.858717434869739171e-01
1.452739502529277471e-01,-1.374608285218369974e-01,2.856602474873227160e-01
1.478883894374360963e-01,-1.346440651109481468e-01,2.840681362725450687e-01
1.495409831423417379e-01,-1.328062286220863253e-01,2.829420666333563594e-01
1.505782470505565573e-01,-1.316289919249614138e-01,2.822645290581163313e-01
1.529974136870484169e-01,-1.288091278018532737e-01,2.804609218436873719e-01
1.536589503275941349e-01,-1.280192445854214656e-01,2.798860372221289583e-01
1.551329822514644907e-01,-1.262289896092288477e-01,2.786573146292585235e-01
1.569394234981354996e-01,-1.239758740726310954e-01,2.768537074148296750e-01
1.576237469294385074e-01,-1.231046481816358007e-01,2.760044035826059727e-01
1.584257462763485891e-01,-1.220708110761209997e-01,2.750501002004008266e-01
1.595813166316805976e-01,-1.205562249827826504e-01,2.732464929859719782e-01
1.603907103807303280e-01,-1.194772782731707839e-01,2.714428857715431298e-01
1.608709989298883203e-01,-1.188298014106725503e-01,2.696392785571142814e-01
1.610428704558378721e-01,-1.185967700881614822e-01,2.678356713426853219e-01
1.609298484109795424e-01,-1.187500900648885971e-01,2.660320641282564735e-01
1.605573627558265493e-01,-1.192532316748436405e-01,2.642284569138277361e-01
1.599518480609710136e-01,-1.200641757639640539e-01,2.624248496993987767e-01
1.591400520464825163e-01,-1.211381188340104886e-01,2.606212424849699283e-01
1.581486732072218127e-01,-1.224295600040911786e-01,2.588176352705411909e-01
1.576237469294385074e-01,-1.231046481816358007e-01,2.579908175768122480e-01
1.570289516654513329e-01,-1.238624573422042047e-01,2.570140280561122315e-01
1.558093223449237286e-01,-1.253932018508805146e-01,2.552104208416833830e-01
1.544950772888075974e-01,-1.270089409983618800e-01,2.534068136272545346e-01
1.536589503275941349e-01,-1.280192445854214656e-01,2.523170996094138974e-01
1.531328390101337200e-01,-1.286480999342643761e-01,2.516032064128256862e-01
1.517615779326115799e-01,-1.302629013318983009e-01,2.497995991983967268e-01
1.503747991971224884e-01,-1.318613657081750823e-01,2.479959919839679894e-01
1.495409831423417379e-01,-1.328062286220863253e-01,2.469070075642406104e-01
1.490146528268938841e-01,-1.333965263523765321e-01,2.461923847695391410e-01
1.477115604359645340e-01,-1.348380321481012778e-01,2.443887775551101815e-01
1.464542453566420321e-01,-1.362026211826207756e-01,2.425851703406814441e-01
1.452739502529277471e-01,-1.374608285218369974e-01,2.408057387059586163e-01
1.452584945351831358e-01,-1.374771608863529504e-01,2.407815631262524847e-01
1.441732863632639305e-01,-1.386148025977611831e-01,2.389779559118236363e-01
1.431708802869626762e-01,-1.396499159965955972e-01,2.371743486973948989e-01
1.422608758574384069e-01,-1.405768231262696510e-01,2.353707414829659395e-01
1.414519855024934103e-01,-1.413907203369527965e-01,2.335671342685370910e-01
1.408621051305343763e-01,-1.419784044782666510e-01,2.320474899781928557e-01
1.407555402651108345e-01,-1.420840521827722858e-01,2.317635270541081316e-01
1.401898596745302095e-01,-1.426422211143514307e-01,2.299599198396793942e-01
1.397424776652448353e-01,-1.430805365379182181e-01,2.281563126252505458e-01
1.394177683773660803e-01,-1.433969520620124727e-01,2.263527054108215864e-01
1.392186971496441050e-01,-1.435902307399625488e-01,2.245490981963928490e-01
1.391469400513189736e-01,-1.436597684613011017e-01,2.227454909819638895e-01
1.392032032658093721e-01,-1.436052512986128737e-01,2.209418837675350411e-01
1.393876535208181666e-01,-1.434262250983422970e-01,2.191382765531063037e-01
1.397003261971245802e-01,-1.431216924872571183e-01,2.173346693386773443e-01
1.401413830654739678e-01,-1.426898481059395152e-01,2.155310621242484959e-01
1.407111444106468878e-01,-1.421280191892016764e-01,2.137274549098196474e-01
1.408621051305343763e-01,-1.419784044782666510e-01,2.133370087182142050e-01
1.414273005999333865e-01,-1.414154116248158011e-01,2.119238476953907990e-01
1.422811436804312935e-01,-1.405563095452796174e-01,2.101202404809619506e-01
1.432670091697205439e-01,-1.395512955280717449e-01,2.083166332665331022e-01
1.443830948399814906e-01,-1.383962496761704797e-01,2.065130260521042538e-01
1.452739502529277471e-01,-1.374608285218369974e-01,2.052195069573932718e-01
1.456385907709520644e-01,-1.370744355386925017e-01,2.047094188376754054e-01
1.470520739222114792e-01,-1.355569531790105642e-01,2.029058116232465570e-01
1.485888996144732188e-01,-1.338706051056765822e-01,2.011022044088177085e-01
1.495409831423417379e-01,-1.328062286220863253e-01,2.000631628607105195e-01
1.502699417553635952e-01,-1.319808493867183630e-01,1.992985971943887491e-01
1.521029781353816779e-01,-1.298640983580435504e-01,1.974949899799599007e-01
1.536589503275941349e-01,-1.280192445854214656e-01,1.960511790458022152e-01
1.540632033667216072e-01,-1.275324639783305958e-01,1.956913827655310523e-01
1.561929504057950335e-01,-1.249150200877894995e-01,1.938877755511022039e-01
1.576237469294385074e-01,-1.231046481816358007e-01,1.927299852450533035e-01
1.584570399961793830e-01,-1.220301867393851492e-01,1.920841683366733554e-01
1.608742738415246398e-01,-1.188253677291265520e-01,1.902805611222445070e-01
1.614314207523970257e-01,-1.180673383873057508e-01,1.898780349222977670e-01
1.634576191437526471e-01,-1.152458534779274013e-01,1.884769539078156586e-01
1.650781762243952455e-01,-1.129123365023836228e-01,1.873842777204752230e-01
1.661812956812528941e-01,-1.112824198411411364e-01,1.866733466933866992e-01
1.685603781802700873e-01,-1.076447811448578151e-01,1.851668238598426774e-01
1.690517305316135699e-01,-1.068714761022169085e-01,1.848697394789579618e-01
1.718745554853823854e-01,-1.022699231284653482e-01,1.831801590621695008e-01
1.720742066269331794e-01,-1.019336422076220494e-01,1.830661322645291134e-01
1.750174044957186759e-01,-9.679312022856786935e-02,1.813899319895985740e-01
1.752518626389865941e-01,-9.636796480971142331e-02,1.812625250501001539e-01
1.779857923510360374e-01,-9.121983184140325385e-02,1.797704539389422540e-01
1.785835260960619564e-01,-9.004401261104022502e-02,1.794589178356714165e-01
1.807767600977646660e-01,-8.555561354204208047e-02,1.783025962775191542e-01
1.820594148407252144e-01,-8.279111949872841603e-02,1.776553106212424571e-01
1.833875256385577301e-01,-7.980611154646828631e-02,1.769722191421748136e-01
1.856531735965369079e-01,-7.438346008041125945e-02,1.758517034068136087e-01
1.858154865055461069e-01,-7.397705708330938601e-02,1.757692067141716774e-01
1.880582224545351566e-01,-6.807426068082252091e-02,1.746837028190242891e-01
1.894181652924324666e-01,-6.419313559290228122e-02,1.740480961923848713e-01
1.901134978775565754e-01,-6.210360637483382240e-02,1.737096576915088675e-01
1.919792640313714160e-01,-5.607104584340286829e-02,1.728405254063767882e-01
1.932967611302636723e-01,-5.134551720013923876e-02,1.722444889779559118e-01
1.936536610797014168e-01,-4.998259247406175443e-02,1.720732957546286523e-01
1.951350199471547364e-01,-4.384431536953829062e-02,1.714009040553136631e-01
1.964218639829960755e-01,-3.766233329794370366e-02,1.708250348439271371e-01
1.973057588551241914e-01,-3.271754151221610563e-02,1.704408817635270634e-01
1.975129104331047325e-01,-3.144280859345021523e-02,1.703414188662137341e-01
1.984070717186515731e-01,-2.519194101354367554e-02,1.699450879560525096e-01
1.991034565202211837e-01,-1.891596155896907785e-02,1.696388859332181309e-01
1.996013706662986831e-01,-1.262112626253492076e-02,1.694212618951709826e-01
1.999003178252347634e-01,-6.313709952962049364e-03,1.692911214928975450e-01
2.000000000000000111e-01,-4.898587196589413075e-17,1.692478134316370286e-01
